Rk,Player,Pos,Age,Tm,G,GS,MP,FG,FGA,FG%,3P,3PA,3P%,2P,2PA,2P%,eFG%,FT,FTA,FT%,ORB,DRB,TRB,AST,STL,BLK,TOV,PF,PTS
1,Precious Achiuwa*/players/a/achiupr01.html,C,22,TOR,21,17,556,71,184,.386,7,26,.269,64,158,.405,.405,19,35,.543,49,124,173,33,11,12,23,53,168
2,Steven Adams*/players/a/adamsst01.html,C,28,MEM,26,26,652,66,127,.520,0,0,None,66,127,.520,.520,50,82,.610,102,125,227,70,22,18,45,44,182
3,Bam Adebayo*/players/a/adebaba01.html,C,24,MIA,18,18,592,126,243,.519,0,1,.000,126,242,.521,.519,85,112,.759,49,134,183,57,20,6,53,59,337
4,Santi Aldama*/players/a/aldamsa01.html,PF,21,MEM,14,0,145,22,63,.349,3,27,.111,19,36,.528,.373,6,10,.600,15,25,40,12,2,3,4,14,53
5,LaMarcus Aldridge*/players/a/aldrila01.html,C,36,BRK,24,7,565,145,252,.575,10,29,.345,135,223,.605,.595,34,42,.810,33,104,137,22,10,28,15,38,334
6,Nickeil Alexander-Walker*/players/a/alexani01.html,SG,23,NOP,28,18,794,142,387,.367,57,187,.305,85,200,.425,.441,40,52,.769,29,81,110,76,27,11,40,50,381
7,Grayson Allen*/players/a/allengr01.html,SG,26,MIL,26,26,745,116,261,.444,78,188,.415,38,73,.521,.594,29,34,.853,13,82,95,33,17,8,17,38,339
8,Jarrett Allen*/players/a/allenja01.html,C,23,CLE,24,24,795,171,241,.710,1,5,.200,170,236,.720,.712,71,103,.689,77,192,269,45,22,31,49,45,414
9,Jose Alvarado*/players/a/alvarjo01.html,PG,23,NOP,8,0,41,5,13,.385,2,5,.400,3,8,.375,.462,2,3,.667,2,3,5,9,4,0,1,3,14
10,Kyle Anderson*/players/a/anderky01.html,PF,28,MEM,22,2,470,69,161,.429,19,52,.365,50,109,.459,.488,15,19,.789,23,91,114,54,18,12,20,31,172
11,Giannis Antetokounmpo*/players/a/antetgi01.html,PF,27,MIL,24,24,783,234,438,.534,28,95,.295,206,343,.601,.566,167,247,.676,49,234,283,137,27,40,79,73,663
12,Thanasis Antetokounmpo*/players/a/antetth01.html,SF,29,MIL,20,5,257,30,62,.484,0,6,.000,30,56,.536,.484,10,17,.588,21,42,63,15,10,4,13,35,70
13,Carmelo Anthony*/players/a/anthoca01.html,PF,37,LAL,27,3,751,123,285,.432,65,160,.406,58,125,.464,.546,55,68,.809,23,88,111,24,20,15,23,65,366
14,Cole Anthony*/players/a/anthoco01.html,PG,21,ORL,20,20,681,142,331,.429,55,151,.364,87,180,.483,.512,67,77,.870,10,113,123,117,19,4,60,51,406
15,OG Anunoby*/players/a/anunoog01.html,SF,24,TOR,15,15,560,114,265,.430,41,112,.366,73,153,.477,.508,33,40,.825,24,57,81,41,23,9,25,41,302
16,D.J. Augustin*/players/a/augusdj01.html,PG,34,HOU,21,0,277,28,66,.424,19,46,.413,9,20,.450,.568,16,18,.889,3,20,23,52,5,0,26,13,91
17,Deni Avdija*/players/a/avdijde01.html,SF,21,WAS,26,0,554,60,141,.426,21,66,.318,39,75,.520,.500,21,32,.656,22,104,126,31,14,19,14,56,162
18,Joel Ayayi*/players/a/ayayijo01.html,SG,21,WAS,4,0,10,0,0,None,0,0,None,0,0,None,None,0,0,None,0,2,2,2,0,0,0,0,0
19,Deandre Ayton*/players/a/aytonde01.html,C,23,PHO,18,18,556,132,215,.614,1,5,.200,131,210,.624,.616,29,47,.617,54,145,199,27,14,13,32,42,294
20,Udoka Azubuike*/players/a/azubuud01.html,C,22,UTA,4,0,8,1,1,1.000,0,0,None,1,1,1.000,1.000,0,0,None,1,3,4,0,0,0,1,0,2
21,Marvin Bagley III*/players/b/baglema01.html,PF,22,SAC,11,0,207,33,64,.516,7,21,.333,26,43,.605,.570,13,18,.722,22,47,69,8,2,2,7,12,86
22,LaMelo Ball*/players/b/ballla01.html,PG,20,CHO,24,24,799,174,416,.418,70,179,.391,104,237,.439,.502,63,70,.900,37,148,185,198,46,10,78,75,481
23,Lonzo Ball*/players/b/balllo01.html,PG,24,CHI,26,26,918,120,288,.417,79,185,.427,41,103,.398,.554,11,14,.786,26,117,143,130,45,26,63,62,330
24,Mo Bamba*/players/b/bambamo01.html,C,23,ORL,25,25,732,107,232,.461,34,101,.337,73,131,.557,.534,18,25,.720,59,162,221,45,20,56,36,68,266
25,Desmond Bane*/players/b/banede01.html,SF,23,MEM,26,26,755,162,347,.467,68,169,.402,94,178,.528,.565,32,35,.914,14,97,111,54,25,11,40,63,424
26,Dalano Banton*/players/b/bantoda01.html,SF,22,TOR,26,0,333,42,93,.452,6,20,.300,36,73,.493,.484,18,24,.750,17,44,61,42,11,5,27,37,108
27,Harrison Barnes*/players/b/barneha02.html,PF,29,SAC,21,21,721,117,250,.468,41,102,.402,76,148,.514,.550,110,130,.846,29,117,146,49,20,3,41,30,385
28,Scottie Barnes*/players/b/barnesc01.html,PF,20,TOR,24,24,864,149,305,.489,17,50,.340,132,255,.518,.516,47,65,.723,70,130,200,79,29,21,47,66,362
29,RJ Barrett*/players/b/barrerj01.html,SF,21,NYK,25,25,784,134,333,.402,47,133,.353,87,200,.435,.473,63,86,.733,20,121,141,52,11,7,42,51,378
30,Will Barton*/players/b/bartowi01.html,SG,31,DEN,23,23,777,146,328,.445,60,153,.392,86,175,.491,.537,24,33,.727,14,103,117,97,21,10,42,32,376
31,Charles Bassey*/players/b/bassech01.html,PF,21,PHI,11,0,86,14,20,.700,0,3,.000,14,17,.824,.700,5,7,.714,10,19,29,2,2,8,4,11,33
32,Keita Bates-Diop*/players/b/bateske01.html,SF,26,SAS,18,5,267,27,61,.443,2,13,.154,25,48,.521,.459,9,13,.692,15,50,65,8,9,6,14,13,65
33,Nicolas Batum*/players/b/batumni01.html,PF,33,LAC,15,14,400,50,97,.515,32,74,.432,18,23,.783,.680,5,10,.500,7,71,78,22,17,12,12,17,137
34,Kent Bazemore*/players/b/bazemke01.html,SF,32,LAL,19,13,354,28,84,.333,14,44,.318,14,40,.350,.417,10,13,.769,6,31,37,15,16,5,8,42,80
35,Darius Bazley*/players/b/bazleda01.html,PF,21,OKC,25,25,686,83,221,.376,24,88,.273,59,133,.444,.430,28,44,.636,23,139,162,33,23,28,35,21,218
36,Bradley Beal*/players/b/bealbr01.html,SG,28,WAS,23,23,828,198,449,.441,34,130,.262,164,319,.514,.479,89,105,.848,22,87,109,132,20,7,78,50,519
37,Malik Beasley*/players/b/beaslma01.html,SG,25,MIN,26,0,671,104,288,.361,72,211,.341,32,77,.416,.486,16,22,.727,10,73,83,41,15,4,18,33,296
38,DeAndre' Bembry*/players/b/bembrde01.html,SF,27,BRK,25,10,492,61,108,.565,9,22,.409,52,86,.605,.606,10,21,.476,19,62,81,27,22,13,18,59,141
39,Dāvis Bertāns*/players/b/bertada01.html,PF,29,WAS,16,0,244,24,81,.296,17,65,.262,7,16,.438,.401,17,18,.944,3,22,25,9,4,2,7,27,82
40,Patrick Beverley*/players/b/beverpa01.html,PG,33,MIN,18,14,457,59,125,.472,20,62,.323,39,63,.619,.552,14,20,.700,25,50,75,81,15,16,21,52,152
41,Saddiq Bey*/players/b/beysa01.html,SF,22,DET,25,25,798,111,319,.348,47,154,.305,64,165,.388,.422,36,49,.735,46,103,149,60,26,4,34,42,305
42,Khem Birch*/players/b/birchkh01.html,C,29,TOR,15,3,344,40,80,.500,0,6,.000,40,74,.541,.500,24,33,.727,48,37,85,20,15,7,9,27,104
43,Goga Bitadze*/players/b/bitadgo01.html,C,22,IND,17,0,142,15,50,.300,4,25,.160,11,25,.440,.340,11,17,.647,18,22,40,3,9,10,6,27,45
44,Nemanja Bjelica*/players/b/bjeline01.html,C,33,GSW,25,0,360,60,130,.462,22,61,.361,38,69,.551,.546,22,31,.710,23,76,99,39,19,9,31,34,164
45,Eric Bledsoe*/players/b/bledser01.html,PG,32,LAC,26,22,685,87,213,.408,20,75,.267,67,138,.486,.455,43,52,.827,19,83,102,90,35,11,52,41,237
46,Keljin Blevins*/players/b/blevike01.html,SF,26,POR,3,0,14,2,4,.500,2,3,.667,0,1,.000,.750,0,0,None,0,1,1,1,0,0,2,0,6
47,Bogdan Bogdanović*/players/b/bogdabo01.html,SG,29,ATL,20,20,564,89,199,.447,43,110,.391,46,89,.517,.555,11,14,.786,7,64,71,49,13,4,18,38,232
48,Bojan Bogdanović*/players/b/bogdabo02.html,PF,32,UTA,25,25,751,141,303,.465,62,155,.400,79,148,.534,.568,78,85,.918,18,79,97,44,11,1,36,36,422
49,Bol Bol*/players/b/bolbo01.html,PF,22,DEN,10,0,47,7,15,.467,0,3,.000,7,12,.583,.467,1,3,.333,2,12,14,2,1,2,0,3,15
50,Leandro Bolmaro*/players/b/bolmale01.html,SF,21,MIN,15,1,150,8,29,.276,1,10,.100,7,19,.368,.293,8,9,.889,13,18,31,8,5,0,9,17,25
51,Isaac Bonga*/players/b/bongais01.html,SF,22,TOR,9,0,49,2,9,.222,1,3,.333,1,6,.167,.278,4,6,.667,2,2,4,3,4,2,1,8,9
52,Devin Booker*/players/b/bookede01.html,SG,25,PHO,21,21,676,180,393,.458,50,124,.403,130,269,.483,.522,78,91,.857,18,85,103,94,19,5,57,49,488
53,Brandon Boston Jr.*/players/b/bostobr01.html,SG,20,LAC,13,0,146,27,59,.458,11,24,.458,16,35,.457,.551,16,17,.941,1,13,14,4,9,3,11,10,81
54,Chris Boucher*/players/b/bouchch01.html,PF,29,TOR,24,2,350,61,151,.404,11,59,.186,50,92,.543,.440,30,42,.714,40,62,102,7,11,20,14,38,163
55,James Bouknight*/players/b/bouknja01.html,SG,21,CHO,11,0,78,14,33,.424,7,13,.538,7,20,.350,.530,4,4,1.000,7,8,15,4,1,0,3,7,39
56,Avery Bradley*/players/b/bradlav01.html,SG,31,LAL,24,19,547,54,130,.415,31,75,.413,23,55,.418,.535,2,2,1.000,12,49,61,18,19,5,13,34,141
57,Tony Bradley*/players/b/bradlto01.html,C,24,CHI,20,7,256,32,58,.552,0,0,None,32,58,.552,.552,5,7,.714,29,58,87,9,1,11,14,26,69
58,Ignas Brazdeikis*/players/b/brazdig01.html,SF,23,ORL,12,0,98,7,28,.250,3,17,.176,4,11,.364,.304,1,2,.500,5,12,17,6,3,0,3,12,18
59,Mikal Bridges*/players/b/bridgmi01.html,SF,25,PHO,25,25,867,124,230,.539,32,76,.421,92,154,.597,.609,25,29,.862,23,77,100,46,36,14,20,55,305
60,Miles Bridges*/players/b/bridgmi02.html,PF,23,CHO,28,28,1036,211,447,.472,59,178,.331,152,269,.565,.538,87,113,.770,33,168,201,98,33,24,55,79,568
61,Oshae Brissett*/players/b/brissos01.html,SF,23,IND,17,0,247,32,69,.464,14,34,.412,18,35,.514,.565,3,11,.273,12,38,50,10,5,4,14,20,81
62,Malcolm Brogdon*/players/b/brogdma01.html,PG,29,IND,23,23,816,163,364,.448,42,138,.304,121,226,.535,.505,90,103,.874,21,106,127,143,21,11,54,50,458
63,Armoni Brooks*/players/b/brookar01.html,SG,23,HOU,21,2,310,46,121,.380,33,99,.333,13,22,.591,.517,11,13,.846,5,32,37,21,12,5,7,30,136
64,Dillon Brooks*/players/b/brookdi01.html,SF,26,MEM,12,11,320,77,189,.407,18,58,.310,59,131,.450,.455,33,36,.917,8,32,40,33,17,2,26,43,205
65,Bruce Brown*/players/b/brownbr01.html,SF,25,BRK,23,14,517,68,147,.463,8,25,.320,60,122,.492,.490,13,17,.765,33,65,98,26,30,10,14,58,157
66,Greg Brown III*/players/b/browngr01.html,SF,20,POR,11,0,51,7,20,.350,0,4,.000,7,16,.438,.350,2,7,.286,5,9,14,5,2,4,2,7,16
67,Jaylen Brown*/players/b/brownja02.html,SF,25,BOS,13,13,426,101,218,.463,31,85,.365,70,133,.526,.534,45,59,.763,6,62,68,29,14,6,31,35,278
68,Moses Brown*/players/b/brownmo01.html,C,22,DAL,11,1,56,8,13,.615,0,0,None,8,13,.615,.615,13,19,.684,6,11,17,0,2,4,4,10,29
69,Sterling Brown*/players/b/brownst02.html,SG,26,DAL,20,0,256,22,62,.355,11,40,.275,11,22,.500,.444,4,4,1.000,14,50,64,15,9,3,14,24,59
70,Troy Brown Jr.*/players/b/browntr01.html,SF,22,CHI,17,0,196,26,62,.419,8,27,.296,18,35,.514,.484,8,12,.667,6,35,41,11,5,1,7,14,68
71,Jalen Brunson*/players/b/brunsja01.html,PG,25,DAL,24,6,701,137,279,.491,23,71,.324,114,208,.548,.532,46,60,.767,16,79,95,115,19,1,34,43,343
72,Reggie Bullock*/players/b/bullore01.html,SF,30,DAL,24,8,566,51,144,.354,29,105,.276,22,39,.564,.455,6,9,.667,5,58,63,17,7,3,15,33,137
73,Trey Burke*/players/b/burketr01.html,PG,29,DAL,13,0,141,31,68,.456,10,24,.417,21,44,.477,.529,10,11,.909,0,9,9,18,5,0,12,9,82
74,Alec Burks*/players/b/burksal01.html,SG,30,NYK,26,7,658,91,225,.404,51,123,.415,40,102,.392,.518,62,76,.816,10,90,100,54,31,8,21,55,295
75,Jared Butler*/players/b/butleja02.html,SG,21,UTA,16,0,70,11,32,.344,6,19,.316,5,13,.385,.438,4,7,.571,0,12,12,8,2,6,8,15,32
76,Jimmy Butler*/players/b/butleji01.html,SF,32,MIA,18,18,607,139,273,.509,6,31,.194,133,242,.550,.520,127,149,.852,29,75,104,94,39,5,35,29,411
77,Devontae Cacok*/players/c/cacokde01.html,PF,25,SAS,1,0,2,1,1,1.000,0,0,None,1,1,1.000,1.000,0,0,None,1,1,2,1,0,0,0,0,2
78,Kentavious Caldwell-Pope*/players/c/caldwke01.html,SG,28,WAS,26,26,760,104,242,.430,55,137,.401,49,105,.467,.543,34,38,.895,15,77,92,44,34,8,32,47,297
79,Facundo Campazzo*/players/c/campafa01.html,PG,30,DEN,24,0,461,49,117,.419,29,75,.387,20,42,.476,.543,17,21,.810,8,33,41,62,22,6,25,45,144
80,Vlatko Čančar*/players/c/cancavl01.html,PF,24,DEN,5,0,27,4,8,.500,3,3,1.000,1,5,.200,.688,3,4,.750,1,1,2,4,1,0,2,3,14
81,Clint Capela*/players/c/capelca01.html,C,27,ATL,26,26,781,134,234,.573,0,1,.000,134,233,.575,.573,31,61,.508,106,227,333,34,24,38,17,63,299
82,Vernon Carey Jr.*/players/c/careyve01.html,C,20,CHO,2,1,12,3,6,.500,0,0,None,3,6,.500,.500,1,1,1.000,2,1,3,0,1,0,1,1,7
83,Jevon Carter*/players/c/carteje01.html,PG,26,BRK,26,1,312,21,75,.280,18,59,.305,3,16,.188,.400,3,4,.750,4,32,36,28,8,7,9,30,63
84,Wendell Carter Jr.*/players/c/cartewe01.html,C,22,ORL,26,26,758,135,262,.515,36,101,.356,99,161,.615,.584,42,60,.700,55,202,257,61,17,17,37,69,348
85,Alex Caruso*/players/c/carusal01.html,SG,27,CHI,23,6,658,65,147,.442,23,69,.333,42,78,.538,.520,42,49,.857,22,64,86,94,51,9,34,61,195
86,Willie Cauley-Stein*/players/c/caulewi01.html,C,28,DAL,18,2,177,16,35,.457,1,2,.500,15,33,.455,.471,1,2,.500,13,25,38,9,6,3,7,17,34
87,Justin Champagnie*/players/c/champju01.html,SF,20,TOR,12,0,59,5,11,.455,0,1,.000,5,10,.500,.455,5,5,1.000,7,5,12,1,0,1,0,7,15
88,Chris Chiozza*/players/c/chiozch01.html,PG,26,GSW,11,0,124,11,30,.367,9,22,.409,2,8,.250,.517,1,1,1.000,5,11,16,18,5,0,9,15,32
89,Josh Christopher*/players/c/chrisjo01.html,SG,20,HOU,17,0,149,26,56,.464,9,18,.500,17,38,.447,.545,7,9,.778,7,13,20,14,11,1,14,12,68
90,Gary Clark*/players/c/clarkga01.html,F,27,NOP,1,0,3,0,0,None,0,0,None,0,0,None,None,0,0,None,0,0,0,0,0,0,0,0,0
91,Brandon Clarke*/players/c/clarkbr01.html,PF,25,MEM,19,0,304,64,105,.610,1,11,.091,63,94,.670,.614,18,27,.667,33,50,83,26,7,17,8,33,147
92,Jordan Clarkson*/players/c/clarkjo01.html,SG,29,UTA,25,0,622,131,353,.371,69,227,.304,62,126,.492,.469,38,47,.809,17,61,78,49,16,6,32,41,369
93,Nicolas Claxton*/players/c/claxtni01.html,C,22,BRK,8,4,133,19,32,.594,0,0,None,19,32,.594,.594,6,14,.429,8,31,39,4,0,5,5,16,44
94,Amir Coffey*/players/c/coffeam01.html,SG,24,LAC,16,3,207,14,40,.350,10,30,.333,4,10,.400,.475,17,19,.895,3,23,26,11,1,2,5,13,55
95,John Collins*/players/c/collijo01.html,PF,24,ATL,26,26,845,170,304,.559,32,80,.400,138,224,.616,.612,72,93,.774,44,158,202,57,20,34,27,76,444
96,Mike Conley*/players/c/conlemi01.html,PG,34,UTA,23,23,646,115,228,.504,61,128,.477,54,100,.540,.638,28,33,.848,7,38,45,123,27,7,42,46,319
97,Pat Connaughton*/players/c/connapa01.html,SG,29,MIL,27,10,783,118,237,.498,74,171,.433,44,66,.667,.654,20,27,.741,23,106,129,36,28,10,21,40,330
98,Tyler Cook*/players/c/cookty01.html,PF,24,CHI,1,0,12,2,3,.667,0,0,None,2,3,.667,.667,2,2,1.000,0,2,2,2,0,0,1,1,6
99,Sharife Cooper*/players/c/coopesh01.html,PG,20,ATL,5,0,11,1,4,.250,0,2,.000,1,2,.500,.250,0,0,None,0,0,0,4,0,0,1,0,2
100,Petr Cornelie*/players/c/cornepe01.html,PF,26,DEN,7,0,23,2,9,.222,0,5,.000,2,4,.500,.222,0,0,None,5,4,9,3,0,0,2,4,4
101,DeMarcus Cousins*/players/c/couside01.html,C,31,MIL,5,0,62,7,20,.350,1,7,.143,6,13,.462,.375,10,12,.833,5,16,21,6,4,0,6,14,25
102,Robert Covington*/players/c/covinro01.html,PF,31,POR,26,26,698,64,162,.395,41,118,.347,23,44,.523,.522,3,3,1.000,14,108,122,30,27,25,27,58,172
103,Torrey Craig*/players/c/craigto01.html,SF,31,IND,27,1,400,52,108,.481,14,53,.264,38,55,.691,.546,17,22,.773,31,54,85,23,11,7,15,41,135
104,Jae Crowder*/players/c/crowdja01.html,PF,31,PHO,25,25,701,81,204,.397,49,141,.348,32,63,.508,.517,27,35,.771,12,111,123,35,32,12,22,56,238
105,Jarrett Culver*/players/c/culveja01.html,SG,22,MEM,9,0,81,18,32,.563,3,10,.300,15,22,.682,.609,4,8,.500,2,12,14,13,5,1,2,3,43
106,Cade Cunningham*/players/c/cunnica01.html,PG,20,DET,20,20,639,113,301,.375,44,144,.306,69,157,.439,.449,35,41,.854,22,101,123,90,27,11,74,52,305
107,Seth Curry*/players/c/curryse01.html,SG,31,PHI,24,24,822,143,281,.509,53,130,.408,90,151,.596,.603,51,58,.879,12,58,70,70,20,3,40,57,390
108,Stephen Curry*/players/c/curryst01.html,PG,33,GSW,24,24,820,214,488,.439,132,320,.413,82,168,.488,.574,99,106,.934,16,115,131,152,42,11,75,44,659
109,Anthony Davis*/players/d/davisan02.html,C,28,LAL,25,25,896,239,457,.523,10,52,.192,229,405,.565,.534,112,155,.723,74,180,254,75,32,54,51,57,600
110,Ed Davis*/players/d/davised01.html,C,32,CLE,9,2,77,7,10,.700,0,0,None,7,10,.700,.700,1,2,.500,4,25,29,1,2,4,3,9,15
111,Terence Davis*/players/d/daviste02.html,SG,24,SAC,18,7,311,64,155,.413,26,88,.295,38,67,.567,.497,15,20,.750,6,46,52,16,15,7,22,43,169
112,Gabriel Deck*/players/d/deckga01.html,PF,26,OKC,6,0,45,6,12,.500,1,3,.333,5,9,.556,.542,0,0,None,1,4,5,3,1,0,2,2,13
113,Dewayne Dedmon*/players/d/dedmode01.html,C,32,MIA,26,8,405,54,98,.551,7,11,.636,47,87,.540,.587,28,36,.778,46,104,150,16,9,12,23,54,143
114,Sam Dekker*/players/d/dekkesa01.html,PF,27,TOR,1,0,1,0,0,None,0,0,None,0,0,None,None,0,0,None,0,0,0,0,0,0,0,0,0
115,DeMar DeRozan*/players/d/derozde01.html,PF,32,CHI,24,24,846,227,456,.498,20,60,.333,207,396,.523,.520,159,179,.888,15,112,127,98,22,9,49,55,633
116,Hamidou Diallo*/players/d/diallha01.html,SG,23,DET,18,1,278,48,93,.516,6,22,.273,42,71,.592,.548,19,25,.760,17,37,54,14,11,9,11,32,121
117,Gorgui Dieng*/players/d/dienggo01.html,C,32,ATL,21,0,177,19,45,.422,7,21,.333,12,24,.500,.500,9,14,.643,21,51,72,15,5,6,11,26,54
118,Spencer Dinwiddie*/players/d/dinwisp01.html,PG,28,WAS,22,22,658,100,255,.392,41,118,.347,59,137,.431,.473,53,60,.883,15,94,109,117,9,4,34,48,294
119,Luka Dončić*/players/d/doncilu01.html,PG,22,DAL,21,21,735,200,447,.447,57,175,.326,143,272,.526,.511,81,116,.698,17,151,168,178,22,11,96,53,538
120,Luguentz Dort*/players/d/dortlu01.html,SF,22,OKC,24,24,788,142,335,.424,60,182,.330,82,153,.536,.513,70,84,.833,17,76,93,46,21,9,39,67,414
121,Ayo Dosunmu*/players/d/dosunay01.html,SG,22,CHI,25,2,447,61,121,.504,17,41,.415,44,80,.550,.574,11,19,.579,12,40,52,29,10,5,20,37,150
122,Devon Dotson*/players/d/dotsode01.html,PG,22,CHI,4,0,33,3,9,.333,0,3,.000,3,6,.500,.333,4,4,1.000,1,5,6,3,0,0,1,4,10
123,Sekou Doumbouya*/players/d/doumbse01.html,PF,21,LAL,2,0,16,5,8,.625,1,2,.500,4,6,.667,.688,3,4,.750,2,4,6,0,3,2,2,1,14
124,Jeff Dowtin*/players/d/dowtije01.html,PG,24,GSW,3,0,10,2,4,.500,0,0,None,2,4,.500,.500,0,0,None,0,2,2,0,0,0,0,1,4
125,PJ Dozier*/players/d/doziepj01.html,SG,25,DEN,18,0,340,36,99,.364,15,48,.313,21,51,.412,.439,10,13,.769,14,49,63,29,11,6,13,33,97
126,Goran Dragić*/players/d/dragigo01.html,PG,35,TOR,5,2,90,13,34,.382,4,14,.286,9,20,.450,.441,10,10,1.000,2,12,14,9,5,1,1,8,40
127,Andre Drummond*/players/d/drumman01.html,C,28,PHI,25,10,509,63,129,.488,0,1,.000,63,128,.492,.488,30,53,.566,79,164,243,50,24,28,45,66,156
128,Chris Duarte*/players/d/duartch01.html,SG,24,IND,26,20,766,135,317,.426,47,137,.343,88,180,.489,.500,29,39,.744,14,91,105,55,28,3,42,46,346
129,David Duke*/players/d/dukeda01.html,G,22,BRK,1,0,22,4,9,.444,1,4,.250,3,5,.600,.500,0,0,None,2,1,3,1,0,0,0,3,9
130,Kevin Durant*/players/d/duranke01.html,PF,33,BRK,24,24,871,250,472,.530,41,110,.373,209,362,.577,.573,143,164,.872,12,170,182,130,16,19,74,41,684
131,Anthony Edwards*/players/e/edwaran01.html,SG,20,MIN,26,26,943,206,489,.421,75,221,.339,131,268,.489,.498,70,90,.778,33,119,152,96,42,19,87,58,557
132,Kessler Edwards*/players/e/edwarke02.html,SF,21,BRK,2,0,12,3,6,.500,2,4,.500,1,2,.500,.667,0,0,None,1,2,3,0,0,0,1,0,8
133,CJ Elleby*/players/e/ellebcj01.html,SF,21,POR,14,0,75,10,22,.455,4,12,.333,6,10,.600,.545,0,0,None,2,16,18,4,0,0,7,11,24
134,Wayne Ellington*/players/e/ellinwa01.html,SG,34,LAL,19,2,383,42,106,.396,39,98,.398,3,8,.375,.580,4,4,1.000,3,23,26,11,8,2,8,19,127
135,Joel Embiid*/players/e/embiijo01.html,C,27,PHI,16,16,526,120,272,.441,21,53,.396,99,219,.452,.480,125,161,.776,30,145,175,67,17,23,42,44,386
136,Drew Eubanks*/players/e/eubandr01.html,C,24,SAS,23,8,335,49,95,.516,1,5,.200,48,90,.533,.521,38,47,.809,29,77,106,30,9,19,29,36,137
137,Tacko Fall*/players/f/fallta01.html,C,26,CLE,8,0,25,2,5,.400,0,0,None,2,5,.400,.400,1,5,.200,1,4,5,0,0,2,1,1,5
138,Derrick Favors*/players/f/favorde01.html,C,30,OKC,19,8,314,52,100,.520,2,9,.222,50,91,.549,.530,9,16,.563,29,69,98,8,9,3,6,24,115
139,Bruno Fernando*/players/f/fernabr01.html,C,23,BOS,8,0,18,2,3,.667,0,0,None,2,3,.667,.667,0,0,None,1,1,2,1,0,1,3,3,4
140,Dorian Finney-Smith*/players/f/finnedo01.html,PF,28,DAL,25,25,794,84,191,.440,44,119,.370,40,72,.556,.555,16,27,.593,41,73,114,40,37,11,24,55,228
141,Malik Fitts*/players/f/fittsma01.html,PF,24,UTA,4,0,10,0,1,.000,0,0,None,0,1,.000,.000,0,0,None,0,3,3,0,0,0,0,0,0
142,Malachi Flynn*/players/f/flynnma01.html,PG,23,TOR,18,0,144,17,52,.327,6,25,.240,11,27,.407,.385,4,7,.571,5,17,22,16,8,2,5,16,44
143,Bryn Forbes*/players/f/forbebr01.html,SG,28,SAS,24,0,339,63,135,.467,28,67,.418,35,68,.515,.570,13,16,.813,2,27,29,17,10,1,20,18,167
144,Trent Forrest*/players/f/forretr01.html,PG,23,UTA,18,0,138,10,17,.588,0,2,.000,10,15,.667,.588,7,8,.875,4,15,19,13,4,0,10,9,27
145,Evan Fournier*/players/f/fournev01.html,SG,29,NYK,26,26,731,119,289,.412,66,171,.386,53,118,.449,.526,25,32,.781,12,61,73,42,24,5,35,45,329
146,De'Aaron Fox*/players/f/foxde01.html,PG,24,SAC,26,26,904,203,455,.446,30,109,.275,173,346,.500,.479,111,149,.745,13,81,94,138,37,13,74,73,547
147,Enes Freedom*/players/k/kanteen01.html,C,29,BOS,16,0,187,27,58,.466,1,3,.333,26,55,.473,.474,15,18,.833,34,54,88,3,3,9,10,18,70
148,Daniel Gafford*/players/g/gaffoda01.html,C,23,WAS,23,23,486,88,133,.662,0,0,None,88,133,.662,.662,30,43,.698,48,94,142,23,12,48,25,60,206
149,Danilo Gallinari*/players/g/gallida01.html,PF,33,ATL,23,0,496,72,171,.421,35,86,.407,37,85,.435,.523,40,43,.930,13,81,94,31,11,6,10,29,219
150,Darius Garland*/players/g/garlada01.html,PG,22,CLE,25,25,860,179,380,.471,67,171,.392,112,209,.536,.559,54,61,.885,11,61,72,185,30,2,98,46,479
151,Marcus Garrett*/players/g/garrema01.html,SG,23,MIA,4,0,10,0,1,.000,0,0,None,0,1,.000,.000,0,0,None,0,1,1,2,0,0,0,1,0
152,Usman Garuba*/players/g/garubus01.html,PF,19,HOU,7,0,45,5,14,.357,2,8,.250,3,6,.500,.429,0,0,None,6,12,18,6,2,4,2,4,12
153,Luka Garza*/players/g/garzalu01.html,C,23,DET,15,2,143,19,45,.422,6,16,.375,13,29,.448,.489,11,14,.786,14,17,31,7,6,1,7,24,55
154,Rudy Gay*/players/g/gayru01.html,PF,35,UTA,11,0,210,40,83,.482,24,55,.436,16,28,.571,.627,10,13,.769,9,49,58,12,4,2,11,19,114
155,Paul George*/players/g/georgpa01.html,SF,31,LAC,24,24,861,220,521,.422,64,201,.318,156,320,.488,.484,95,108,.880,10,165,175,130,45,9,102,62,599
156,Taj Gibson*/players/g/gibsota01.html,C,36,NYK,12,1,223,15,32,.469,0,3,.000,15,29,.517,.469,7,9,.778,23,33,56,8,4,14,12,38,37
157,Josh Giddey*/players/g/giddejo01.html,SG,19,OKC,23,23,680,101,250,.404,21,81,.259,80,169,.473,.446,21,30,.700,32,122,154,136,22,14,67,42,244
158,Shai Gilgeous-Alexander*/players/g/gilgesh01.html,PG,23,OKC,22,22,767,160,390,.410,42,141,.298,118,249,.474,.464,108,135,.800,12,90,102,111,21,14,53,44,470
159,Anthony Gill*/players/g/gillan01.html,PF,29,WAS,10,0,52,8,11,.727,3,3,1.000,5,8,.625,.864,7,8,.875,5,10,15,2,0,2,2,5,26
160,Rudy Gobert*/players/g/goberru01.html,C,29,UTA,25,25,794,132,182,.725,0,1,.000,132,181,.729,.725,108,160,.675,77,291,368,24,22,55,46,67,372
161,Aaron Gordon*/players/g/gordoaa01.html,PF,26,DEN,25,25,816,135,258,.523,25,72,.347,110,186,.591,.572,58,78,.744,47,98,145,55,16,19,38,54,353
162,Eric Gordon*/players/g/gordoer01.html,SG,33,HOU,22,11,655,113,238,.475,51,117,.436,62,121,.512,.582,39,55,.709,5,36,41,63,13,13,54,25,316
163,Devonte' Graham*/players/g/grahade01.html,PG,26,NOP,25,25,775,114,307,.371,70,201,.348,44,106,.415,.485,38,48,.792,14,48,62,111,29,4,42,35,336
164,Jerami Grant*/players/g/grantje01.html,PF,27,DET,24,24,797,158,382,.414,42,127,.331,116,255,.455,.469,124,146,.849,23,93,116,62,27,27,51,54,482
165,Danny Green*/players/g/greenda02.html,SF,34,PHI,19,16,456,49,113,.434,38,95,.400,11,18,.611,.602,4,4,1.000,12,37,49,23,25,17,21,38,140
166,Draymond Green*/players/g/greendr01.html,PF,31,GSW,24,24,726,77,140,.550,7,23,.304,70,117,.598,.575,32,55,.582,29,164,193,182,33,24,75,62,193
167,Jalen Green*/players/g/greenja05.html,SG,19,HOU,18,18,555,87,228,.382,32,115,.278,55,113,.487,.452,46,57,.807,7,49,56,42,11,4,49,28,252
168,JaMychal Green*/players/g/greenja01.html,PF,31,DEN,24,4,353,52,125,.416,13,58,.224,39,67,.582,.468,18,23,.783,22,59,81,20,20,11,25,52,135
169,Javonte Green*/players/g/greenja02.html,SF,28,CHI,23,12,474,48,97,.495,10,26,.385,38,71,.535,.546,18,24,.750,35,63,98,16,19,8,16,45,124
170,Jeff Green*/players/g/greenje02.html,C,35,DEN,25,16,618,84,176,.477,19,59,.322,65,117,.556,.531,51,63,.810,11,66,77,28,7,13,22,56,238
171,Josh Green*/players/g/greenjo02.html,SG,21,DAL,14,0,75,11,21,.524,0,2,.000,11,19,.579,.524,0,2,.000,5,8,13,4,3,1,2,11,22
172,Blake Griffin*/players/g/griffbl01.html,PF,32,BRK,18,17,382,37,111,.333,9,56,.161,28,55,.509,.374,17,24,.708,21,66,87,34,9,10,9,42,100
173,Quentin Grimes*/players/g/grimequ01.html,SG,21,NYK,13,0,79,8,21,.381,8,19,.421,0,2,.000,.571,0,0,None,2,8,10,3,0,1,3,7,24
174,Tyrese Haliburton*/players/h/halibty01.html,SG,21,SAC,24,24,808,112,252,.444,46,110,.418,66,142,.465,.536,22,29,.759,26,68,94,138,44,18,47,31,292
175,R.J. Hampton*/players/h/hamptrj01.html,SG,20,ORL,26,0,480,67,165,.406,26,65,.400,41,100,.410,.485,33,56,.589,9,70,79,59,13,4,42,37,193
176,Tim Hardaway Jr.*/players/h/hardati02.html,SG,29,DAL,25,19,788,127,327,.388,58,179,.324,69,148,.466,.477,46,63,.730,10,85,95,54,26,3,16,46,358
177,James Harden*/players/h/hardeja01.html,PG,32,BRK,26,26,942,154,381,.404,64,190,.337,90,191,.471,.488,170,192,.885,23,183,206,250,36,17,130,62,542
178,Maurice Harkless*/players/h/harklma01.html,SF,28,SAC,17,14,331,25,65,.385,9,40,.225,16,25,.640,.454,8,11,.727,3,42,45,9,8,8,7,26,67
179,Montrezl Harrell*/players/h/harremo01.html,C,28,WAS,26,3,683,149,230,.648,2,8,.250,147,222,.662,.652,94,125,.752,64,144,208,56,15,18,35,52,394
180,Gary Harris*/players/h/harriga01.html,SG,27,ORL,20,10,512,64,151,.424,20,70,.286,44,81,.543,.490,11,15,.733,16,28,44,33,14,2,22,37,159
181,Joe Harris*/players/h/harrijo01.html,SF,30,BRK,14,14,423,56,124,.452,41,88,.466,15,36,.417,.617,5,6,.833,5,51,56,14,7,2,16,31,158
182,Tobias Harris*/players/h/harrito02.html,PF,29,PHI,17,17,587,129,271,.476,22,69,.319,107,202,.530,.517,45,54,.833,19,120,139,57,7,10,27,25,325
183,Josh Hart*/players/h/hartjo01.html,PF,26,NOP,21,20,646,88,176,.500,16,49,.327,72,127,.567,.545,44,51,.863,25,115,140,86,19,7,36,63,236
184,Isaiah Hartenstein*/players/h/harteis01.html,C,23,LAC,25,0,390,76,117,.650,2,3,.667,74,114,.649,.658,27,44,.614,45,71,116,39,21,31,23,62,181
185,Udonis Haslem*/players/h/hasleud01.html,C,41,MIA,5,0,23,3,6,.500,0,1,.000,3,5,.600,.500,0,0,None,1,5,6,1,0,1,0,5,6
186,Sam Hauser*/players/h/hausesa01.html,SF,24,BOS,2,0,5,0,2,.000,0,2,.000,0,0,None,.000,0,0,None,0,1,1,0,1,0,0,1,0
187,Jaxson Hayes*/players/h/hayesja02.html,C,21,NOP,20,0,234,40,79,.506,4,11,.364,36,68,.529,.532,28,37,.757,25,39,64,5,5,12,13,32,112
188,Killian Hayes*/players/h/hayeski01.html,PG,20,DET,20,20,516,44,132,.333,20,57,.351,24,75,.320,.409,18,19,.947,12,59,71,74,23,8,31,54,126
189,Gordon Hayward*/players/h/haywago01.html,SF,31,CHO,28,28,970,174,384,.453,47,128,.367,127,256,.496,.514,99,116,.853,24,112,136,109,24,18,55,53,494
190,Aaron Henry*/players/h/henryaa01.html,SF,22,PHI,1,0,2,0,1,.000,0,1,.000,0,0,None,.000,0,0,None,0,0,0,0,0,0,0,0,0
191,Juan Hernangómez*/players/h/hernaju01.html,PF,26,BOS,14,0,61,4,18,.222,2,12,.167,2,6,.333,.278,4,5,.800,6,11,17,1,4,0,5,4,14
192,Willy Hernangómez*/players/h/hernawi01.html,C,27,NOP,14,0,200,48,76,.632,2,2,1.000,46,74,.622,.645,18,25,.720,33,60,93,22,6,3,15,27,116
193,Tyler Herro*/players/h/herroty01.html,SG,22,MIA,23,7,764,183,412,.444,62,158,.392,121,254,.476,.519,51,59,.864,18,105,123,87,14,2,73,30,479
194,Buddy Hield*/players/h/hieldbu01.html,SG,29,SAC,26,2,737,135,359,.376,90,259,.347,45,100,.450,.501,42,50,.840,19,90,109,56,18,6,40,53,402
195,George Hill*/players/h/hillge01.html,SG,35,MIL,22,11,600,61,138,.442,22,67,.328,39,71,.549,.522,26,28,.929,20,60,80,55,18,3,23,40,170
196,Solomon Hill*/players/h/hillso01.html,PF,30,ATL,13,1,139,3,20,.150,2,13,.154,1,7,.143,.200,0,0,None,6,17,23,12,4,2,1,16,8
197,Aaron Holiday*/players/h/holidaa01.html,PG,25,WAS,25,7,423,58,130,.446,13,37,.351,45,93,.484,.496,13,17,.765,4,34,38,49,14,8,27,39,142
198,Jrue Holiday*/players/h/holidjr01.html,PG,31,MIL,21,20,674,135,293,.461,37,104,.356,98,189,.519,.524,27,38,.711,15,83,98,129,28,12,57,46,334
199,Justin Holiday*/players/h/holidju01.html,SF,32,IND,23,15,647,82,206,.398,55,154,.357,27,52,.519,.532,8,11,.727,6,59,65,38,12,7,21,48,227
200,Richaun Holmes*/players/h/holmeri01.html,C,28,SAC,22,22,596,130,184,.707,2,4,.500,128,180,.711,.712,46,57,.807,59,146,205,30,6,21,31,67,308
201,Rodney Hood*/players/h/hoodro01.html,SF,29,MIL,20,0,292,19,63,.302,11,41,.268,8,22,.364,.389,10,10,1.000,7,32,39,14,7,1,2,18,59
202,Al Horford*/players/h/horfoal01.html,C,35,BOS,23,23,677,103,227,.454,29,100,.290,74,127,.583,.518,48,56,.857,35,148,183,81,18,36,25,50,283
203,Talen Horton-Tucker*/players/h/hortota01.html,SG,21,LAL,14,11,402,58,146,.397,12,48,.250,46,98,.469,.438,22,25,.880,10,57,67,40,13,8,22,44,150
204,Danuel House*/players/h/houseda01.html,SF,28,HOU,16,1,233,25,74,.338,10,34,.294,15,40,.375,.405,17,19,.895,4,39,43,19,5,5,18,16,77
205,Dwight Howard*/players/h/howardw01.html,C,36,LAL,24,2,354,43,68,.632,6,8,.750,37,60,.617,.676,27,44,.614,37,93,130,11,18,15,23,43,119
206,Markus Howard*/players/h/howarma02.html,SG,22,DEN,13,0,66,8,29,.276,5,21,.238,3,8,.375,.362,4,4,1.000,0,2,2,4,4,0,3,2,25
207,Kevin Huerter*/players/h/huertke01.html,SG,23,ATL,25,15,681,109,225,.484,47,114,.412,62,111,.559,.589,11,13,.846,8,76,84,61,10,6,34,45,276
208,Jay Huff*/players/h/huffja01.html,C,23,LAL,1,0,8,0,1,.000,0,1,.000,0,0,None,.000,0,0,None,1,1,2,1,0,0,0,0,0
209,Elijah Hughes*/players/h/hugheel01.html,SF,23,UTA,6,0,17,0,2,.000,0,1,.000,0,1,.000,.000,2,2,1.000,0,1,1,0,0,0,1,2,2
210,De'Andre Hunter*/players/h/huntede01.html,SF,24,ATL,11,11,306,50,111,.450,15,38,.395,35,73,.479,.518,4,10,.400,4,26,30,7,7,3,14,32,119
211,Chandler Hutchison*/players/h/hutchch01.html,SF,25,PHO,4,0,12,1,2,.500,0,0,None,1,2,.500,.500,0,0,None,0,5,5,1,0,0,3,1,2
212,Bones Hyland*/players/h/hylanbo01.html,PG,21,DEN,17,0,267,44,120,.367,26,77,.338,18,43,.419,.475,20,21,.952,4,26,30,27,13,3,14,29,134
213,Serge Ibaka*/players/i/ibakase01.html,C,32,LAC,11,3,154,17,47,.362,8,20,.400,9,27,.333,.447,5,8,.625,12,22,34,13,2,3,6,21,47
214,Andre Iguodala*/players/i/iguodan01.html,SF,38,GSW,12,0,250,18,43,.419,5,23,.217,13,20,.650,.477,4,6,.667,8,34,42,45,9,10,9,12,45
215,Joe Ingles*/players/i/inglejo01.html,SF,34,UTA,25,5,616,72,154,.468,51,122,.418,21,32,.656,.633,9,11,.818,12,63,75,86,13,3,27,41,204
216,Brandon Ingram*/players/i/ingrabr01.html,SF,24,NOP,21,21,736,177,396,.447,39,105,.371,138,291,.474,.496,84,98,.857,17,112,129,99,11,9,64,45,477
217,Frank Jackson*/players/j/jacksfr01.html,PG,23,DET,25,2,541,84,210,.400,43,133,.323,41,77,.532,.502,32,38,.842,6,28,34,21,13,5,22,35,243
218,Isaiah Jackson*/players/j/jacksis01.html,PF,20,IND,6,0,33,4,12,.333,0,0,None,4,12,.333,.333,1,2,.500,3,6,9,0,1,1,1,9,9
219,Jaren Jackson Jr.*/players/j/jacksja02.html,PF,22,MEM,26,26,710,148,344,.430,58,162,.358,90,182,.495,.515,75,90,.833,29,114,143,25,24,50,40,88,429
220,Josh Jackson*/players/j/jacksjo02.html,SF,24,DET,22,3,405,56,135,.415,18,62,.290,38,73,.521,.481,23,33,.697,11,59,70,35,10,10,23,38,153
221,Reggie Jackson*/players/j/jacksre01.html,SG,31,LAC,26,26,870,170,437,.389,71,218,.326,99,219,.452,.470,37,47,.787,17,75,92,106,16,3,54,49,448
222,LeBron James*/players/j/jamesle01.html,SF,37,LAL,15,15,551,148,296,.500,41,118,.347,107,178,.601,.569,53,69,.768,10,77,87,103,29,12,54,32,390
223,DeJon Jarreau*/players/j/jarrede01.html,SG,24,IND,1,0,1,0,0,None,0,0,None,0,0,None,None,0,0,None,0,0,0,0,0,0,0,0,0
224,Ty Jerome*/players/j/jeromty01.html,SG,24,OKC,20,1,276,46,116,.397,20,66,.303,26,50,.520,.483,24,29,.828,6,17,23,23,14,2,10,25,136
225,Isaiah Joe*/players/j/joeis01.html,SG,22,PHI,15,0,143,18,50,.360,13,39,.333,5,11,.455,.490,4,4,1.000,2,15,17,11,2,0,6,11,53
226,Alize Johnson*/players/j/johnsal02.html,PF,25,CHI,15,0,116,12,23,.522,0,2,.000,12,21,.571,.522,4,7,.571,16,19,35,8,3,0,8,13,28
227,Cameron Johnson*/players/j/johnsca02.html,PF,25,PHO,25,0,590,85,200,.425,51,125,.408,34,75,.453,.553,23,31,.742,8,78,86,32,19,7,18,36,244
228,David Johnson*/players/j/johnsda08.html,SG,20,TOR,2,0,2,0,1,.000,0,1,.000,0,0,None,.000,0,0,None,0,0,0,0,0,0,0,0,0
229,Jalen Johnson*/players/j/johnsja05.html,PF,20,ATL,7,0,19,5,10,.500,2,4,.500,3,6,.500,.600,2,2,1.000,0,5,5,0,0,0,0,0,14
230,James Johnson*/players/j/johnsja01.html,PF,34,BRK,17,1,304,36,76,.474,5,16,.313,31,60,.517,.507,6,14,.429,15,51,66,30,9,7,10,43,83
231,Keldon Johnson*/players/j/johnske04.html,SF,22,SAS,23,23,716,128,275,.465,26,64,.406,102,211,.483,.513,49,77,.636,26,121,147,44,22,4,32,39,331
232,Keon Johnson*/players/j/johnske07.html,SG,19,LAC,3,0,16,0,4,.000,0,1,.000,0,3,.000,.000,4,4,1.000,1,2,3,2,1,0,1,3,4
233,Nikola Jokić*/players/j/jokicni01.html,C,26,DEN,20,20,657,205,354,.579,32,91,.352,173,263,.658,.624,79,106,.745,49,218,267,144,24,14,66,51,521
234,Damian Jones*/players/j/jonesda03.html,C,26,SAC,10,0,84,12,17,.706,1,2,.500,11,15,.733,.735,7,11,.636,11,14,25,5,0,3,2,12,32
235,Derrick Jones Jr.*/players/j/jonesde02.html,PF,24,CHI,22,2,406,58,99,.586,8,25,.320,50,74,.676,.626,30,36,.833,30,47,77,12,12,21,12,52,154
236,Herb Jones*/players/j/joneshe01.html,C,23,NOP,25,16,676,72,154,.468,10,26,.385,62,128,.484,.500,23,30,.767,30,55,85,45,35,21,28,76,177
237,Kai Jones*/players/j/joneska01.html,C,21,CHO,7,0,14,2,3,.667,0,0,None,2,3,.667,.667,1,2,.500,1,2,3,0,0,0,3,1,5
238,Tre Jones*/players/j/jonestr01.html,PG,22,SAS,22,0,225,34,71,.479,0,5,.000,34,66,.515,.479,11,11,1.000,4,22,26,36,9,0,14,17,79
239,Tyus Jones*/players/j/jonesty01.html,PG,25,MEM,26,7,513,70,155,.452,24,60,.400,46,95,.484,.529,20,22,.909,5,62,67,109,23,2,20,12,184
240,DeAndre Jordan*/players/j/jordade01.html,C,33,LAL,21,16,287,46,67,.687,0,0,None,46,67,.687,.687,7,12,.583,34,90,124,8,8,17,18,36,99
241,Cory Joseph*/players/j/josepco01.html,PG,30,DET,24,4,504,50,118,.424,12,40,.300,38,78,.487,.475,36,43,.837,7,37,44,83,20,5,35,36,148
242,Georgios Kalaitzakis*/players/k/kalaige01.html,SF,23,MIL,9,0,48,5,11,.455,2,4,.500,3,7,.429,.545,4,9,.444,4,4,8,0,1,1,4,8,16
243,Frank Kaminsky*/players/k/kaminfr01.html,C,28,PHO,9,0,181,36,66,.545,5,15,.333,31,51,.608,.583,18,20,.900,11,30,41,13,8,7,5,14,95
244,Luke Kennard*/players/k/kennalu01.html,SG,25,LAC,26,1,728,99,228,.434,67,153,.438,32,75,.427,.581,16,17,.941,6,81,87,46,21,2,21,38,281
245,Louis King*/players/k/kinglo02.html,SF,22,SAC,3,0,49,7,21,.333,4,14,.286,3,7,.429,.429,6,7,.857,0,7,7,1,2,0,0,7,24
246,Corey Kispert*/players/k/kispeco01.html,SF,22,WAS,23,0,279,32,78,.410,11,46,.239,21,32,.656,.481,11,14,.786,10,31,41,12,5,3,8,10,86
247,Maxi Kleber*/players/k/klebima01.html,PF,30,DAL,16,3,349,37,89,.416,23,64,.359,14,25,.560,.545,14,20,.700,18,63,81,12,7,14,10,35,111
248,Nathan Knight*/players/k/knighna01.html,PF,24,MIN,11,0,42,5,8,.625,0,1,.000,5,7,.714,.625,11,14,.786,4,9,13,3,1,2,3,5,21
249,Kevin Knox*/players/k/knoxke01.html,SF,22,NYK,6,0,22,2,7,.286,1,4,.250,1,3,.333,.357,1,2,.500,2,0,2,1,0,0,2,2,6
250,John Konchar*/players/k/konchjo01.html,SG,25,MEM,24,0,370,39,72,.542,11,27,.407,28,45,.622,.618,7,14,.500,24,64,88,33,20,5,13,27,96
251,Furkan Korkmaz*/players/k/korkmfu01.html,SG,24,PHI,25,5,558,77,208,.370,37,124,.298,40,84,.476,.459,23,28,.821,7,63,70,60,17,3,24,21,214
252,Vit Krejci*/players/k/krejcvi01.html,SG,21,OKC,3,0,9,0,2,.000,0,2,.000,0,0,None,.000,2,2,1.000,0,3,3,0,0,0,1,0,2
253,Arnoldas Kulboka*/players/k/kulboar01.html,F,24,CHO,1,0,3,0,0,None,0,0,None,0,0,None,None,0,0,None,0,0,0,0,0,0,0,0,0
254,Jonathan Kuminga*/players/k/kuminjo01.html,SF,19,GSW,15,0,113,20,46,.435,2,15,.133,18,31,.581,.457,9,15,.600,8,18,26,5,5,2,8,17,51
255,Kyle Kuzma*/players/k/kuzmaky01.html,PF,26,WAS,26,26,853,128,301,.425,54,152,.355,74,149,.497,.515,38,56,.679,25,192,217,75,16,18,53,55,348
256,Jeremy Lamb*/players/l/lambje01.html,SF,29,IND,21,0,289,44,116,.379,23,62,.371,21,54,.389,.478,32,32,1.000,7,46,53,24,10,7,12,24,143
257,Jock Landale*/players/l/landajo01.html,C,26,SAS,8,0,24,8,10,.800,2,3,.667,6,7,.857,.900,2,3,.667,2,0,2,2,0,1,1,1,20
258,Romeo Langford*/players/l/langfro01.html,SG,22,BOS,21,0,385,39,92,.424,15,37,.405,24,55,.436,.505,9,13,.692,21,46,67,11,9,3,11,28,102
259,Zach LaVine*/players/l/lavinza01.html,SF,26,CHI,26,26,910,246,505,.487,72,191,.377,174,314,.554,.558,106,125,.848,9,127,136,110,13,9,68,41,670
260,Jake Layman*/players/l/laymaja01.html,SF,27,MIN,9,0,43,4,13,.308,2,6,.333,2,7,.286,.385,0,0,None,1,6,7,1,1,1,2,2,10
261,Damion Lee*/players/l/leeda03.html,SG,29,GSW,19,0,391,59,138,.428,21,64,.328,38,74,.514,.504,22,26,.846,7,53,60,21,7,2,12,27,161
262,Saben Lee*/players/l/leesa01.html,PG,22,DET,10,0,122,14,40,.350,4,19,.211,10,21,.476,.400,7,12,.583,2,16,18,16,9,2,6,6,39
263,Alex Len*/players/l/lenal01.html,C,28,SAC,18,4,290,41,78,.526,6,15,.400,35,63,.556,.564,18,27,.667,17,52,69,18,4,18,20,54,106
264,Caris LeVert*/players/l/leverca01.html,SG,27,IND,20,20,562,125,292,.428,26,90,.289,99,202,.490,.473,34,43,.791,9,48,57,63,18,11,30,38,310
265,Kira Lewis Jr.*/players/l/lewiski01.html,PG,20,NOP,24,0,341,59,146,.404,13,58,.224,46,88,.523,.449,10,12,.833,9,30,39,49,11,1,26,17,141
266,Damian Lillard*/players/l/lillada01.html,PG,31,POR,20,20,714,146,368,.397,55,182,.302,91,186,.489,.471,82,90,.911,8,71,79,156,13,8,52,28,429
267,Nassir Little*/players/l/littlna01.html,SF,21,POR,22,3,495,70,144,.486,22,67,.328,48,77,.623,.563,30,39,.769,30,88,118,17,16,14,20,46,192
268,Kevon Looney*/players/l/looneke01.html,C,25,GSW,25,25,443,56,107,.523,0,1,.000,56,106,.528,.523,24,43,.558,60,98,158,28,13,17,16,61,136
269,Brook Lopez*/players/l/lopezbr01.html,C,33,MIL,1,1,28,3,9,.333,2,4,.500,1,5,.200,.444,0,0,None,2,3,5,0,1,3,0,3,8
270,Robin Lopez*/players/l/lopezro01.html,C,33,ORL,9,1,136,27,43,.628,0,1,.000,27,42,.643,.628,11,18,.611,17,9,26,9,0,5,9,14,65
271,Didi Louzada*/players/l/louzama01.html,SF,22,NOP,2,0,7,0,3,.000,0,3,.000,0,0,None,.000,0,0,None,2,0,2,1,0,0,0,0,0
272,Kevin Love*/players/l/loveke01.html,PF,33,CLE,19,0,383,68,169,.402,36,96,.375,32,73,.438,.509,44,46,.957,21,117,138,39,5,5,21,19,216
273,Kyle Lowry*/players/l/lowryky01.html,PG,35,MIA,24,24,821,112,264,.424,49,157,.312,63,107,.589,.517,47,54,.870,12,95,107,188,25,8,75,66,320
274,Timothé Luwawu-Cabarrot*/players/l/luwawti01.html,SF,26,ATL,19,5,204,23,65,.354,16,43,.372,7,22,.318,.477,5,6,.833,4,20,24,10,4,3,3,25,67
275,Trey Lyles*/players/l/lylestr01.html,PF,26,DET,25,0,415,66,154,.429,21,68,.309,45,86,.523,.497,43,54,.796,34,73,107,18,7,4,22,35,196
276,Théo Maledon*/players/m/maledth01.html,PG,20,OKC,13,0,159,10,41,.244,3,26,.115,7,15,.467,.280,13,15,.867,5,18,23,13,4,2,15,10,36
277,Sandro Mamukelashvili*/players/m/mamuksa01.html,PF,22,MIL,12,1,114,14,31,.452,4,11,.364,10,20,.500,.516,2,3,.667,14,14,28,6,0,1,3,6,34
278,Terance Mann*/players/m/mannte01.html,SF,25,LAC,25,1,686,89,194,.459,23,68,.338,66,126,.524,.518,36,46,.783,38,94,132,57,16,2,29,58,237
279,Tre Mann*/players/m/manntr01.html,PG,20,OKC,17,2,273,49,118,.415,17,48,.354,32,70,.457,.487,13,18,.722,7,23,30,5,10,5,13,24,128
280,Boban Marjanović*/players/m/marjabo01.html,C,33,DAL,13,0,81,29,45,.644,1,2,.500,28,43,.651,.656,6,13,.462,6,20,26,2,0,2,8,16,65
281,Lauri Markkanen*/players/m/markkla01.html,PF,24,CLE,18,18,558,94,218,.431,44,123,.358,50,95,.526,.532,34,40,.850,21,80,101,22,15,9,13,26,266
282,Naji Marshall*/players/m/marshna01.html,SF,24,NOP,19,0,209,19,61,.311,3,24,.125,16,37,.432,.336,25,29,.862,14,40,54,20,8,3,19,20,66
283,Caleb Martin*/players/m/martica02.html,SF,26,MIA,23,2,450,66,135,.489,20,53,.377,46,82,.561,.563,23,36,.639,19,54,73,22,20,13,13,34,175
284,Cody Martin*/players/m/martico01.html,SF,26,CHO,26,3,702,86,174,.494,28,58,.483,58,116,.500,.575,33,45,.733,37,79,116,65,36,15,18,47,233
285,Kelan Martin*/players/m/martike03.html,SF,26,IND,21,1,357,60,140,.429,18,60,.300,42,80,.525,.493,7,11,.636,14,26,40,20,11,8,13,28,145
286,Kenyon Martin Jr.*/players/m/martike04.html,SF,21,HOU,24,0,377,67,122,.549,9,33,.273,58,89,.652,.586,17,27,.630,15,58,73,25,9,11,10,26,160
287,Garrison Mathews*/players/m/mathega01.html,SG,25,HOU,12,7,346,51,106,.481,38,91,.418,13,15,.867,.660,21,27,.778,10,27,37,4,10,6,3,32,161
288,Wesley Matthews*/players/m/matthwe02.html,SG,35,MIL,4,0,56,4,11,.364,2,8,.250,2,3,.667,.455,0,2,.000,1,4,5,1,2,1,2,6,10
289,Tyrese Maxey*/players/m/maxeyty01.html,PG,21,PHI,25,25,867,155,333,.465,27,75,.360,128,258,.496,.506,76,86,.884,11,82,93,117,19,14,31,59,413
290,Skylar Mays*/players/m/mayssk01.html,SG,24,ATL,7,0,19,4,5,.800,1,2,.500,3,3,1.000,.900,5,5,1.000,0,2,2,1,0,0,2,2,14
291,Miles McBride*/players/m/mcbrimi01.html,PG,21,NYK,7,0,12,2,11,.182,0,6,.000,2,5,.400,.182,2,2,1.000,1,1,2,2,2,1,0,1,6
292,CJ McCollum*/players/m/mccolcj01.html,SG,30,POR,24,24,848,191,451,.424,77,196,.393,114,255,.447,.509,35,50,.700,27,72,99,107,26,17,46,51,494
293,T.J. McConnell*/players/m/mccontj01.html,PG,29,IND,24,6,581,91,181,.503,7,25,.280,84,156,.538,.522,12,15,.800,19,61,80,115,25,9,28,43,201
294,Jaden McDaniels*/players/m/mcdanja02.html,PF,21,MIN,23,11,573,56,146,.384,16,64,.250,40,82,.488,.438,10,14,.714,34,64,98,19,22,13,22,83,138
295,Jalen McDaniels*/players/m/mcdanja01.html,SF,24,CHO,22,0,331,42,80,.525,20,44,.455,22,36,.611,.650,16,25,.640,13,59,72,21,8,8,13,37,120
296,Doug McDermott*/players/m/mcderdo01.html,PF,30,SAS,17,17,432,75,159,.472,38,87,.437,37,72,.514,.591,10,13,.769,8,32,40,23,3,1,11,22,198
297,JaVale McGee*/players/m/mcgeeja01.html,C,34,PHO,25,7,398,113,172,.657,1,2,.500,112,170,.659,.660,35,53,.660,64,118,182,15,8,22,39,60,262
298,Rodney McGruder*/players/m/mcgruro01.html,SG,30,DET,9,0,48,5,14,.357,2,8,.250,3,6,.500,.429,2,2,1.000,2,4,6,3,0,1,1,1,14
299,JaQuori McLaughlin*/players/m/mclauja01.html,PG,24,DAL,2,0,5,0,1,.000,0,0,None,0,1,.000,.000,0,0,None,0,0,0,2,0,0,0,0,0
300,Jordan McLaughlin*/players/m/mclaujo01.html,PG,25,MIN,18,0,197,13,44,.295,4,20,.200,9,24,.375,.341,9,11,.818,3,14,17,38,11,0,12,7,39
301,Ben McLemore*/players/m/mclembe01.html,SG,28,POR,11,0,138,21,50,.420,16,43,.372,5,7,.714,.580,6,7,.857,3,8,11,8,3,0,6,10,64
302,De'Anthony Melton*/players/m/meltode01.html,SG,23,MEM,23,13,573,91,223,.408,43,120,.358,48,103,.466,.504,15,22,.682,22,74,96,60,37,14,37,37,240
303,Sam Merrill*/players/m/merrisa01.html,SG,25,MEM,6,0,58,8,24,.333,7,23,.304,1,1,1.000,.479,2,4,.500,1,6,7,4,0,0,2,3,25
304,Chimezie Metu*/players/m/metuch01.html,C,24,SAC,13,10,301,43,109,.394,15,56,.268,28,53,.528,.463,11,15,.733,14,73,87,14,11,12,14,15,112
305,Khris Middleton*/players/m/middlkh01.html,SF,30,MIL,19,19,594,118,287,.411,42,119,.353,76,168,.452,.484,68,78,.872,11,93,104,96,21,3,59,37,346
306,Patty Mills*/players/m/millspa02.html,PG,33,BRK,26,12,751,114,255,.447,78,175,.446,36,80,.450,.600,18,20,.900,7,36,43,59,15,7,21,34,324
307,Paul Millsap*/players/m/millspa01.html,PF,36,BRK,21,0,235,27,76,.355,6,25,.240,21,51,.412,.395,12,17,.706,25,52,77,21,5,7,10,44,72
308,Shake Milton*/players/m/miltosh01.html,PG,25,PHI,21,5,531,92,200,.460,21,63,.333,71,137,.518,.513,33,37,.892,11,53,64,60,14,9,22,40,238
309,Davion Mitchell*/players/m/mitchda01.html,PG,23,SAC,26,0,664,98,253,.387,30,104,.288,68,149,.456,.447,20,30,.667,17,50,67,89,19,5,26,59,246
310,Donovan Mitchell*/players/m/mitchdo01.html,SG,25,UTA,24,24,779,220,486,.453,78,224,.348,142,262,.542,.533,73,83,.880,22,74,96,121,40,5,72,59,591
311,Evan Mobley*/players/m/mobleev01.html,PF,20,CLE,23,23,767,126,262,.481,14,42,.333,112,220,.509,.508,54,69,.783,39,149,188,57,21,45,39,49,320
312,Malik Monk*/players/m/monkma01.html,SG,23,LAL,27,2,648,101,224,.451,48,131,.366,53,93,.570,.558,20,25,.800,11,63,74,59,20,7,36,41,270
313,Moses Moody*/players/m/moodymo01.html,SG,19,GSW,16,0,93,11,28,.393,2,15,.133,9,13,.692,.429,1,2,.500,1,10,11,3,1,2,1,4,25
314,Ja Morant*/players/m/moranja01.html,PG,22,MEM,19,19,619,170,357,.476,31,87,.356,139,270,.515,.520,87,112,.777,25,81,106,129,30,5,60,25,458
315,Marcus Morris*/players/m/morrima03.html,PF,32,LAC,10,10,296,47,112,.420,22,58,.379,25,54,.463,.518,13,16,.813,2,35,37,21,5,4,15,26,129
316,Markieff Morris*/players/m/morrima02.html,PF,32,MIA,10,0,187,32,70,.457,8,22,.364,24,48,.500,.514,5,5,1.000,13,15,28,14,3,1,12,22,77
317,Monte Morris*/players/m/morrimo01.html,PG,26,DEN,25,25,755,129,274,.471,35,102,.343,94,172,.547,.535,9,13,.692,6,61,67,107,20,3,31,39,302
318,Mychal Mulder*/players/m/muldemy01.html,PG,27,ORL,12,1,130,13,49,.265,10,34,.294,3,15,.200,.367,2,2,1.000,2,12,14,1,3,1,4,8,38
319,Trey Murphy III*/players/m/murphtr02.html,SF,21,NOP,26,0,374,40,109,.367,31,80,.388,9,29,.310,.509,9,10,.900,18,42,60,14,8,4,10,32,120
320,Dejounte Murray*/players/m/murrade01.html,PG,25,SAS,24,24,835,189,423,.447,35,101,.347,154,322,.478,.488,40,57,.702,25,176,201,203,46,9,59,50,453
321,Mike Muscala*/players/m/muscami01.html,C,30,OKC,19,0,268,49,110,.445,31,73,.425,18,37,.486,.586,24,30,.800,9,52,61,10,7,10,9,24,153
322,Svi Mykhailiuk*/players/m/mykhasv01.html,SF,24,TOR,26,4,471,64,153,.418,28,87,.322,36,66,.545,.510,20,22,.909,16,50,66,27,20,3,19,33,176
323,Abdel Nader*/players/n/naderab01.html,SF,28,PHO,14,0,145,12,35,.343,4,14,.286,8,21,.381,.400,6,10,.600,4,23,27,7,8,4,11,20,34
324,Larry Nance Jr.*/players/n/nancela02.html,PF,29,POR,26,0,529,65,125,.520,12,42,.286,53,83,.639,.568,18,29,.621,37,93,130,39,23,9,20,38,160
325,RJ Nembhard*/players/n/nembhrj01.html,SG,22,CLE,2,0,3,1,1,1.000,0,0,None,1,1,1.000,1.000,0,0,None,0,1,1,1,0,0,0,0,2
326,Aaron Nesmith*/players/n/nesmiaa01.html,SF,22,BOS,22,0,216,25,70,.357,12,47,.255,13,23,.565,.443,4,5,.800,7,27,34,8,7,1,12,29,66
327,Raul Neto*/players/n/netora01.html,PG,29,WAS,25,0,495,76,163,.466,11,42,.262,65,121,.537,.500,28,39,.718,4,45,49,66,19,1,31,38,191
328,Georges Niang*/players/n/niangge01.html,PF,28,PHI,26,5,621,101,229,.441,53,138,.384,48,91,.527,.557,27,29,.931,6,61,67,41,16,8,19,67,282
329,Daishen Nix*/players/n/nixda01.html,SG,19,HOU,1,0,2,0,0,None,0,0,None,0,0,None,None,0,0,None,0,0,0,1,0,0,0,0,0
330,Zeke Nnaji*/players/n/nnajize01.html,PF,21,DEN,13,0,179,29,58,.500,17,29,.586,12,29,.414,.647,10,16,.625,13,27,40,4,1,5,6,19,85
331,Nerlens Noel*/players/n/noelne01.html,C,27,NYK,12,5,275,19,35,.543,0,2,.000,19,33,.576,.543,12,14,.857,29,41,70,10,12,14,12,32,50
332,Jaylen Nowell*/players/n/nowelja01.html,SG,22,MIN,12,0,79,16,40,.400,3,11,.273,13,29,.448,.438,2,4,.500,3,8,11,12,3,3,1,3,37
333,Frank Ntilikina*/players/n/ntilila01.html,PG,23,DAL,18,0,242,28,80,.350,15,44,.341,13,36,.361,.444,12,12,1.000,3,29,32,23,12,3,11,19,83
334,Jusuf Nurkić*/players/n/nurkiju01.html,C,27,POR,26,26,645,133,230,.578,5,21,.238,128,209,.612,.589,76,102,.745,64,202,266,61,28,14,52,79,347
335,David Nwaba*/players/n/nwabada01.html,SF,29,HOU,17,0,187,24,56,.429,1,15,.067,23,41,.561,.438,14,22,.636,10,41,51,10,11,5,8,18,63
336,Jordan Nwora*/players/n/nworajo01.html,SF,23,MIL,21,0,372,55,139,.396,26,72,.361,29,67,.433,.489,11,13,.846,11,57,68,24,5,9,25,21,147
337,Royce O'Neale*/players/o/onealro01.html,SF,28,UTA,23,23,716,67,134,.500,37,92,.402,30,42,.714,.638,13,19,.684,23,93,116,55,36,16,27,52,184
338,Semi Ojeleye*/players/o/ojelese01.html,PF,27,MIL,11,0,218,12,47,.255,6,28,.214,6,19,.316,.319,3,5,.600,21,19,40,4,4,5,5,17,33
339,Chuma Okeke*/players/o/okekech01.html,PF,23,ORL,20,0,418,50,134,.373,14,62,.226,36,72,.500,.425,23,27,.852,13,67,80,24,14,6,16,25,137
340,Josh Okogie*/players/o/okogijo01.html,SG,23,MIN,18,5,258,16,48,.333,5,20,.250,11,28,.393,.385,10,20,.500,17,24,41,17,11,5,9,25,47
341,Isaac Okoro*/players/o/okorois01.html,SF,21,CLE,20,16,576,58,148,.392,13,59,.220,45,89,.506,.436,28,38,.737,29,51,80,35,17,6,21,46,157
342,KZ Okpala*/players/o/okpalkz01.html,PF,22,MIA,13,0,103,9,24,.375,3,12,.250,6,12,.500,.438,6,8,.750,5,17,22,6,2,3,1,9,27
343,Kelly Olynyk*/players/o/olynyke01.html,C,30,DET,10,1,230,45,98,.459,14,41,.341,31,57,.544,.531,21,35,.600,13,40,53,23,14,7,15,27,125
344,Eugene Omoruyi*/players/o/omorueu01.html,SF,24,DAL,4,0,18,2,5,.400,1,2,.500,1,3,.333,.500,2,4,.500,2,5,7,2,0,0,0,2,7
345,Miye Oni*/players/o/onimi01.html,SG,24,UTA,12,0,36,1,5,.200,0,4,.000,1,1,1.000,.200,0,1,.000,0,5,5,4,0,0,1,5,2
346,Cedi Osman*/players/o/osmande01.html,SF,26,CLE,21,0,473,83,179,.464,49,119,.412,34,60,.567,.601,22,30,.733,7,49,56,38,23,7,20,37,237
347,Kelly Oubre Jr.*/players/o/oubreke01.html,SF,26,CHO,28,9,820,177,382,.463,83,215,.386,94,167,.563,.572,37,57,.649,35,83,118,36,30,10,30,70,474
348,Kevin Pangos*/players/p/pangoke01.html,PG,29,CLE,10,0,34,3,8,.375,2,5,.400,1,3,.333,.500,1,2,.500,1,1,2,6,1,0,4,5,9
349,Jabari Parker*/players/p/parkeja01.html,PF,26,BOS,9,0,84,14,27,.519,5,9,.556,9,18,.500,.611,8,8,1.000,4,16,20,4,3,1,5,11,41
350,Eric Paschall*/players/p/pascher01.html,PF,25,UTA,21,0,238,25,60,.417,11,38,.289,14,22,.636,.508,12,17,.706,13,26,39,14,3,3,12,17,73
351,Chris Paul*/players/p/paulch01.html,PG,36,PHO,25,25,808,129,269,.480,25,75,.333,104,194,.536,.526,77,93,.828,7,91,98,255,49,9,59,52,360
352,Cameron Payne*/players/p/payneca01.html,PG,27,PHO,20,0,368,72,187,.385,22,70,.314,50,117,.427,.444,35,42,.833,8,50,58,61,11,6,36,36,201
353,Elfrid Payton*/players/p/paytoel01.html,PG,27,PHO,11,0,126,20,46,.435,0,2,.000,20,44,.455,.435,4,8,.500,6,18,24,23,5,1,8,9,44
354,Gary Payton II*/players/p/paytoga02.html,PG,29,GSW,24,1,351,64,96,.667,13,33,.394,51,63,.810,.734,19,29,.655,25,51,76,18,31,3,12,41,160
355,Jamorko Pickett*/players/p/pickeja01.html,PF,24,DET,3,0,9,1,1,1.000,1,1,1.000,0,0,None,1.500,0,0,None,0,0,0,0,0,0,1,0,3
356,Mason Plumlee*/players/p/plumlma01.html,C,31,CHO,20,20,523,59,99,.596,0,0,None,59,99,.596,.596,18,52,.346,51,94,145,55,17,20,24,60,136
357,Jakob Poeltl*/players/p/poeltja01.html,C,26,SAS,17,16,497,97,158,.614,0,0,None,97,158,.614,.614,12,37,.324,73,85,158,45,8,28,25,51,206
358,Aleksej Pokusevski*/players/p/pokusal01.html,PF,20,OKC,25,0,362,48,140,.343,12,61,.197,36,79,.456,.386,5,10,.500,26,77,103,29,12,12,29,30,113
359,Yves Pons*/players/p/ponsyv01.html,SF,22,MEM,2,0,4,0,1,.000,0,0,None,0,1,.000,.000,0,0,None,1,0,1,0,0,0,0,0,0
360,Jordan Poole*/players/p/poolejo01.html,SG,22,GSW,25,25,761,160,357,.448,69,200,.345,91,157,.580,.545,61,67,.910,8,72,80,87,28,6,61,72,450
361,Kevin Porter Jr.*/players/p/porteke02.html,PG,21,HOU,19,19,574,83,232,.358,34,110,.309,49,122,.402,.431,44,70,.629,16,68,84,110,25,6,76,43,244
362,Michael Porter Jr.*/players/p/portemi01.html,SF,23,DEN,9,9,265,37,103,.359,10,48,.208,27,55,.491,.408,5,9,.556,9,50,59,17,10,2,12,16,89
363,Otto Porter*/players/p/porteot01.html,PF,28,GSW,22,0,427,56,124,.452,38,89,.427,18,35,.514,.605,15,19,.789,16,87,103,24,19,7,14,30,165
364,Bobby Portis*/players/p/portibo01.html,C,26,MIL,22,18,627,128,271,.472,41,101,.406,87,170,.512,.548,42,53,.792,61,138,199,30,19,24,37,59,339
365,Kristaps Porziņģis*/players/p/porzikr01.html,PF,26,DAL,18,18,540,128,280,.457,30,100,.300,98,180,.544,.511,67,75,.893,40,98,138,37,15,26,24,44,353
366,Dwight Powell*/players/p/poweldw01.html,C,30,DAL,25,22,502,56,96,.583,7,19,.368,49,77,.636,.620,28,41,.683,50,64,114,30,12,14,18,62,147
367,Norman Powell*/players/p/powelno01.html,SF,28,POR,22,22,667,129,278,.464,41,103,.398,88,175,.503,.538,84,102,.824,7,46,53,39,18,8,28,43,383
368,Joshua Primo*/players/p/primojo01.html,SG,19,SAS,8,0,59,6,11,.545,4,8,.500,2,3,.667,.727,0,0,None,1,5,6,4,3,4,0,4,16
369,Taurean Prince*/players/p/princta02.html,PF,27,MIN,24,8,370,37,101,.366,21,68,.309,16,33,.485,.470,16,21,.762,11,39,50,19,10,5,13,36,111
370,Payton Pritchard*/players/p/pritcpa01.html,SG,24,BOS,21,0,200,19,70,.271,15,47,.319,4,23,.174,.379,5,5,1.000,7,18,25,31,1,2,13,15,58
371,Immanuel Quickley*/players/q/quickim01.html,PG,22,NYK,26,1,554,83,214,.388,43,128,.336,40,86,.465,.488,39,42,.929,11,51,62,62,16,0,25,53,248
372,Jahmi'us Ramsey*/players/r/ramseja01.html,SG,20,SAC,7,0,46,5,14,.357,1,6,.167,4,8,.500,.393,2,4,.500,0,0,0,2,0,1,0,3,13
373,Julius Randle*/players/r/randlju01.html,PF,27,NYK,26,26,918,184,428,.430,45,136,.331,139,292,.476,.482,95,125,.760,48,212,260,136,19,18,85,71,508
374,Austin Reaves*/players/r/reaveau01.html,SG,23,LAL,15,0,278,28,58,.483,10,33,.303,18,25,.720,.569,13,15,.867,5,26,31,15,3,2,11,24,79
375,Cam Reddish*/players/r/reddica01.html,SF,22,ATL,22,0,489,83,207,.401,34,92,.370,49,115,.426,.483,45,50,.900,18,41,59,21,23,4,29,31,245
376,Davon Reed*/players/r/reedda01.html,SG,26,DEN,4,0,59,6,12,.500,3,5,.600,3,7,.429,.625,0,0,None,1,10,11,5,5,1,2,4,15
377,Paul Reed*/players/r/reedpa01.html,C,22,PHI,14,2,137,18,35,.514,0,3,.000,18,32,.563,.514,0,0,None,16,22,38,8,9,9,6,21,36
378,Naz Reid*/players/r/reidna01.html,C,22,MIN,24,1,394,81,173,.468,22,62,.355,59,111,.532,.532,35,50,.700,32,54,86,17,13,22,20,59,219
379,Nick Richards*/players/r/richani01.html,C,24,CHO,22,4,209,34,49,.694,0,0,None,34,49,.694,.694,15,18,.833,21,27,48,7,4,13,13,34,83
380,Josh Richardson*/players/r/richajo01.html,SG,28,BOS,20,0,488,71,153,.464,23,65,.354,48,88,.545,.539,28,34,.824,13,43,56,26,12,9,14,37,193
381,Austin Rivers*/players/r/riverau01.html,SG,29,DEN,18,3,314,27,78,.346,13,48,.271,14,30,.467,.429,3,6,.500,7,19,26,14,9,2,10,22,70
382,Duncan Robinson*/players/r/robindu01.html,SG,27,MIA,26,26,725,97,264,.367,74,222,.333,23,42,.548,.508,11,15,.733,8,81,89,35,20,6,22,73,279
383,Justin Robinson*/players/r/robinju01.html,PG,24,MIL,17,0,198,18,57,.316,10,37,.270,8,20,.400,.404,2,2,1.000,2,11,13,21,8,0,11,17,48
384,Mitchell Robinson*/players/r/robinmi01.html,C,23,NYK,23,20,568,62,84,.738,0,0,None,62,84,.738,.738,32,50,.640,72,106,178,15,10,41,14,63,156
385,Jeremiah Robinson-Earl*/players/r/robinje02.html,C,21,OKC,25,18,548,65,155,.419,26,77,.338,39,78,.500,.503,14,21,.667,45,104,149,22,13,7,21,37,170
386,Isaiah Roby*/players/r/robyis01.html,PF,23,OKC,13,1,164,32,62,.516,5,15,.333,27,47,.574,.556,14,17,.824,14,21,35,10,3,5,9,15,83
387,Rajon Rondo*/players/r/rondora01.html,PG,35,LAL,14,0,208,20,63,.317,7,25,.280,13,38,.342,.373,0,0,None,8,26,34,50,11,3,23,20,47
388,Derrick Rose*/players/r/rosede01.html,PG,33,NYK,23,1,553,109,243,.449,32,81,.395,77,162,.475,.514,28,29,.966,20,51,71,89,18,12,35,13,278
389,Terrence Ross*/players/r/rosste01.html,SG,30,ORL,25,0,624,89,225,.396,35,116,.302,54,109,.495,.473,42,52,.808,6,48,54,51,12,4,38,30,255
390,Terry Rozier*/players/r/roziete01.html,SG,27,CHO,19,19,626,124,289,.429,49,140,.350,75,149,.503,.514,40,46,.870,12,55,67,68,25,10,26,26,337
391,Ricky Rubio*/players/r/rubiori01.html,PG,31,CLE,27,5,775,116,325,.357,48,140,.343,68,185,.368,.431,70,83,.843,12,97,109,172,30,4,72,60,350
392,D'Angelo Russell*/players/r/russeda01.html,PG,25,MIN,21,21,686,138,361,.382,60,186,.323,78,175,.446,.465,63,76,.829,10,71,81,135,18,16,56,46,399
393,Domantas Sabonis*/players/s/sabondo01.html,C,25,IND,28,27,954,194,332,.584,22,71,.310,172,261,.659,.617,99,130,.762,90,243,333,118,31,10,84,93,509
394,Tomáš Satoranský*/players/s/satorto01.html,SG,30,NOP,23,3,347,25,72,.347,3,18,.167,22,54,.407,.368,12,16,.750,13,35,48,46,7,0,18,29,65
395,Dennis Schröder*/players/s/schrode01.html,SG,28,BOS,26,17,869,165,371,.445,41,120,.342,124,251,.494,.500,84,94,.894,17,77,94,128,24,1,67,62,455
396,Jay Scrubb*/players/s/scrubja01.html,SG,21,LAC,7,0,48,11,26,.423,4,12,.333,7,14,.500,.500,1,2,.500,0,4,4,4,1,2,1,3,27
397,Wayne Selden*/players/s/seldewa01.html,SG,27,NYK,1,0,1,0,0,None,0,0,None,0,0,None,None,0,0,None,0,0,0,0,0,0,0,0,0
398,Alperen Şengün*/players/s/sengual01.html,C,19,HOU,24,2,425,71,142,.500,10,28,.357,61,114,.535,.535,59,85,.694,34,73,107,59,26,14,41,72,211
399,Collin Sexton*/players/s/sextoco01.html,SG,23,CLE,11,11,316,68,151,.450,11,45,.244,57,106,.538,.487,29,39,.744,13,23,36,23,10,0,31,25,176
400,Landry Shamet*/players/s/shamela01.html,SG,24,PHO,24,4,481,60,160,.375,43,108,.398,17,52,.327,.509,26,31,.839,5,54,59,40,6,2,13,28,189
401,Day'Ron Sharpe*/players/s/sharpda01.html,PF,20,BRK,8,0,36,9,17,.529,1,3,.333,8,14,.571,.559,2,5,.400,8,9,17,0,2,2,6,4,21
402,Pascal Siakam*/players/s/siakapa01.html,PF,27,TOR,15,15,512,105,230,.457,18,53,.340,87,177,.492,.496,56,74,.757,29,86,115,57,9,12,34,50,284
403,Marko Simonovic*/players/s/simonma01.html,C,22,CHI,2,0,8,0,1,.000,0,1,.000,0,0,None,.000,1,2,.500,0,1,1,0,0,0,1,0,1
404,Anfernee Simons*/players/s/simonan01.html,SG,22,POR,22,3,505,100,218,.459,45,118,.381,55,100,.550,.562,18,19,.947,11,47,58,48,10,4,25,35,263
405,Jericho Sims*/players/s/simsje01.html,PF,23,NYK,9,0,58,3,3,1.000,0,0,None,3,3,1.000,1.000,3,4,.750,3,12,15,1,2,4,2,4,9
406,Javonte Smart*/players/s/smartja01.html,PG,22,MIL,4,0,55,6,16,.375,2,9,.222,4,7,.571,.438,5,6,.833,4,7,11,6,1,0,2,4,19
407,Marcus Smart*/players/s/smartma01.html,PG,27,BOS,26,26,893,101,264,.383,35,125,.280,66,139,.475,.449,50,66,.758,14,86,100,139,57,7,51,62,287
408,Dennis Smith Jr.*/players/s/smithde03.html,PG,24,POR,15,3,274,34,80,.425,5,18,.278,29,62,.468,.456,19,27,.704,6,30,36,50,21,6,27,22,92
409,Ish Smith*/players/s/smithis01.html,PG,33,CHO,18,1,245,40,96,.417,3,6,.500,37,90,.411,.432,3,8,.375,2,21,23,44,8,4,16,13,86
410,Jalen Smith*/players/s/smithja04.html,PF,21,PHO,8,0,57,10,22,.455,1,8,.125,9,14,.643,.477,6,7,.857,6,18,24,1,2,3,2,6,27
411,Tony Snell*/players/s/snellto01.html,SG,30,POR,20,3,243,13,43,.302,9,33,.273,4,10,.400,.407,1,1,1.000,2,26,28,12,4,3,4,17,36
412,Jaden Springer*/players/s/sprinja01.html,SG,19,PHI,1,0,2,0,0,None,0,0,None,0,0,None,None,0,0,None,0,0,0,0,0,0,0,0,0
413,Lamar Stevens*/players/s/stevela01.html,PF,24,CLE,17,0,168,18,49,.367,6,17,.353,12,32,.375,.429,4,7,.571,10,15,25,5,4,4,6,21,46
414,Isaiah Stewart*/players/s/stewais01.html,C,20,DET,23,23,581,77,138,.558,1,12,.083,76,126,.603,.562,17,25,.680,56,127,183,27,9,28,24,59,172
415,Max Strus*/players/s/strusma01.html,SF,25,MIA,19,0,384,57,124,.460,38,91,.418,19,33,.576,.613,13,18,.722,5,52,57,15,8,2,12,28,165
416,Jalen Suggs*/players/s/suggsja01.html,PG,20,ORL,21,21,583,87,257,.339,26,102,.255,61,155,.394,.389,58,76,.763,16,55,71,75,24,9,67,58,258
417,Jae'Sean Tate*/players/t/tateja01.html,SF,26,HOU,25,25,708,118,240,.492,18,66,.273,100,174,.575,.529,48,66,.727,49,106,155,77,20,17,49,86,302
418,Jayson Tatum*/players/t/tatumja01.html,SF,23,BOS,27,27,979,243,587,.414,73,223,.327,170,364,.467,.476,132,162,.815,31,205,236,97,24,21,75,67,691
419,Garrett Temple*/players/t/templga01.html,SG,35,NOP,26,9,488,48,126,.381,28,76,.368,20,50,.400,.492,19,24,.792,20,56,76,29,25,15,21,44,143
420,Daniel Theis*/players/t/theisda01.html,C,29,HOU,17,15,388,54,110,.491,16,51,.314,38,59,.644,.564,18,24,.750,18,64,82,14,7,9,21,42,142
421,Brodric Thomas*/players/t/thomabr01.html,SG,25,BOS,2,0,2,0,0,None,0,0,None,0,0,None,None,0,0,None,1,0,1,0,0,0,1,0,0
422,Cameron Thomas*/players/t/thomaca02.html,SG,20,BRK,19,0,245,37,97,.381,9,40,.225,28,57,.491,.428,14,18,.778,4,27,31,13,7,3,4,7,97
423,Matt Thomas*/players/t/thomama02.html,SG,27,CHI,8,0,49,5,19,.263,2,9,.222,3,10,.300,.316,0,0,None,0,5,5,0,2,1,0,3,12
424,Tristan Thompson*/players/t/thomptr01.html,PF,30,SAC,18,0,262,45,84,.536,0,0,None,45,84,.536,.536,21,38,.553,48,55,103,10,6,8,16,33,111
425,JT Thor*/players/t/thorjt01.html,PF,19,CHO,6,0,77,7,17,.412,3,12,.250,4,5,.800,.500,3,6,.500,2,8,10,5,2,3,1,9,20
426,Matisse Thybulle*/players/t/thybuma01.html,SG,24,PHI,19,5,467,45,92,.489,12,45,.267,33,47,.702,.554,6,6,1.000,10,34,44,20,35,22,19,38,108
427,Killian Tillie*/players/t/tilliki02.html,C,23,MEM,12,0,113,12,33,.364,7,21,.333,5,12,.417,.470,1,2,.500,5,6,11,3,6,7,4,12,32
428,Xavier Tillman Sr.*/players/t/tillmxa01.html,PF,23,MEM,19,0,265,35,83,.422,5,24,.208,30,59,.508,.452,14,21,.667,24,35,59,26,23,7,13,20,89
429,Isaiah Todd*/players/t/toddis01.html,PF,20,WAS,4,0,11,2,6,.333,2,3,.667,0,3,.000,.500,1,2,.500,1,1,2,0,2,1,1,1,7
430,Obi Toppin*/players/t/toppiob01.html,PF,23,NYK,26,0,413,88,166,.530,9,46,.196,79,120,.658,.557,41,52,.788,31,70,101,24,9,16,24,40,226
431,Juan Toscano-Anderson*/players/t/toscaju01.html,SF,28,GSW,24,1,395,49,92,.533,9,32,.281,40,60,.667,.582,17,26,.654,14,57,71,53,16,10,29,34,124
432,Karl-Anthony Towns*/players/t/townska01.html,C,26,MIN,25,25,860,214,424,.505,63,146,.432,151,278,.543,.579,110,136,.809,72,157,229,82,26,28,87,91,601
433,Gary Trent Jr.*/players/t/trentga02.html,SG,23,TOR,24,23,831,151,351,.430,66,172,.384,85,179,.475,.524,40,44,.909,11,67,78,43,49,8,22,51,408
434,P.J. Tucker*/players/t/tuckepj01.html,PF,36,MIA,26,26,719,68,137,.496,27,64,.422,41,73,.562,.595,14,17,.824,41,101,142,50,19,7,21,66,177
435,Myles Turner*/players/t/turnemy01.html,C,25,IND,27,27,794,127,239,.531,51,128,.398,76,111,.685,.638,48,67,.716,41,160,201,25,15,74,35,69,353
436,Jonas Valančiūnas*/players/v/valanjo01.html,C,29,NOP,28,28,873,202,391,.517,31,67,.463,171,324,.528,.556,91,111,.820,96,238,334,69,16,26,58,89,526
437,Denzel Valentine*/players/v/valende01.html,SG,28,CLE,17,0,107,10,36,.278,7,23,.304,3,13,.231,.375,0,0,None,6,12,18,3,5,0,6,9,27
438,Jarred Vanderbilt*/players/v/vandeja01.html,PF,22,MIN,25,18,587,60,112,.536,1,8,.125,59,104,.567,.540,26,32,.813,76,130,206,30,36,19,26,70,147
439,Fred VanVleet*/players/v/vanvlfr01.html,PG,27,TOR,25,25,953,173,402,.430,81,208,.389,92,194,.474,.531,65,76,.855,19,109,128,161,38,15,79,67,492
440,Devin Vassell*/players/v/vassede01.html,SF,21,SAS,19,0,467,84,179,.469,34,90,.378,50,89,.562,.564,16,22,.727,9,62,71,25,22,14,13,38,218
441,Gabe Vincent*/players/v/vincega01.html,PG,25,MIA,23,1,396,53,122,.434,28,76,.368,25,46,.543,.549,13,16,.813,11,25,36,52,15,3,26,47,147
442,Nikola Vučević*/players/v/vucevni01.html,C,31,CHI,19,19,630,121,292,.414,31,90,.344,90,202,.446,.467,20,32,.625,33,169,202,69,18,20,31,45,293
443,Dean Wade*/players/w/wadede01.html,PF,25,CLE,18,11,373,32,78,.410,17,53,.321,15,25,.600,.519,5,6,.833,12,43,55,21,11,1,5,33,86
444,Franz Wagner*/players/w/wagnefr01.html,SF,20,ORL,26,26,823,137,310,.442,37,98,.378,100,212,.472,.502,49,60,.817,34,80,114,73,31,12,31,62,360
445,Moritz Wagner*/players/w/wagnemo01.html,C,24,ORL,24,0,266,44,101,.436,23,65,.354,21,36,.583,.550,26,35,.743,10,46,56,17,3,5,18,45,137
446,Ish Wainright*/players/w/wainris01.html,PF,27,PHO,7,0,33,1,11,.091,0,5,.000,1,6,.167,.091,0,2,.000,3,2,5,2,2,0,3,9,2
447,Kemba Walker*/players/w/walkeke02.html,PG,31,NYK,18,18,441,76,177,.429,38,92,.413,38,85,.447,.537,20,25,.800,2,44,46,55,19,5,24,19,210
448,Lonnie Walker*/players/w/walkelo01.html,SG,23,SAS,24,3,537,90,237,.380,37,124,.298,53,113,.469,.458,31,37,.838,3,67,70,61,16,8,30,31,248
449,Brad Wanamaker*/players/w/wanambr01.html,PG,32,IND,16,0,201,20,55,.364,4,14,.286,16,41,.390,.400,15,17,.882,4,22,26,34,2,6,16,31,59
450,Duane Washington Jr.*/players/w/washidu02.html,PG,21,IND,3,0,7,2,4,.500,1,3,.333,1,1,1.000,.625,0,0,None,0,1,1,0,0,0,0,0,5
451,P.J. Washington*/players/w/washipj01.html,PF,23,CHO,15,3,375,56,123,.455,30,67,.448,26,56,.464,.577,16,23,.696,18,60,78,29,11,19,21,32,158
452,Yuta Watanabe*/players/w/watanyu01.html,SF,27,TOR,7,0,120,12,36,.333,9,26,.346,3,10,.300,.458,5,10,.500,5,15,20,6,4,3,1,10,38
453,Trendon Watford*/players/w/watfotr01.html,SF,21,POR,5,0,24,5,11,.455,0,0,None,5,11,.455,.455,2,3,.667,1,2,3,3,1,1,1,1,12
454,Paul Watson*/players/w/watsopa01.html,SF,27,OKC,5,0,78,2,15,.133,2,13,.154,0,2,.000,.200,1,2,.500,2,10,12,3,1,3,3,5,7
455,Russell Westbrook*/players/w/westbru01.html,PG,33,LAL,27,27,972,197,439,.449,36,111,.324,161,328,.491,.490,97,143,.678,35,174,209,231,32,6,125,83,527
456,Coby White*/players/w/whiteco01.html,PG,21,CHI,9,1,158,22,63,.349,7,31,.226,15,32,.469,.405,4,7,.571,1,22,23,12,1,1,8,15,55
457,Derrick White*/players/w/whitede01.html,SG,27,SAS,24,24,755,120,289,.415,39,130,.300,81,159,.509,.483,49,60,.817,13,75,88,121,27,23,34,53,328
458,Hassan Whiteside*/players/w/whiteha01.html,C,32,UTA,23,0,351,64,109,.587,0,0,None,64,109,.587,.587,34,48,.708,50,100,150,7,5,30,23,67,162
459,Joe Wieskamp*/players/w/wieskjo01.html,SG,22,SAS,3,0,8,1,1,1.000,1,1,1.000,0,0,None,1.500,0,0,None,0,0,0,0,0,0,0,1,3
460,Aaron Wiggins*/players/w/wiggiaa01.html,SG,23,OKC,9,1,130,8,18,.444,6,16,.375,2,2,1.000,.611,4,7,.571,1,13,14,10,3,1,7,15,26
461,Andrew Wiggins*/players/w/wiggian01.html,SF,26,GSW,25,25,761,170,349,.487,54,130,.415,116,219,.530,.564,68,93,.731,29,81,110,42,20,13,40,41,462
462,Grant Williams*/players/w/willigr01.html,PF,23,BOS,27,9,589,65,130,.500,38,88,.432,27,42,.643,.646,24,28,.857,16,71,87,28,11,17,17,54,192
463,Kenrich Williams*/players/w/willike04.html,SF,27,OKC,22,0,450,58,128,.453,17,46,.370,41,82,.500,.520,17,32,.531,26,53,79,43,22,5,18,37,150
464,Lou Williams*/players/w/willilo02.html,PG,35,ATL,21,0,283,48,127,.378,13,39,.333,35,88,.398,.429,22,26,.846,6,27,33,26,12,2,18,20,131
465,Patrick Williams*/players/w/willipa01.html,PF,20,CHI,5,5,125,13,23,.565,3,6,.500,10,17,.588,.630,4,4,1.000,1,10,11,3,3,2,2,9,33
466,Robert Williams*/players/w/williro04.html,C,24,BOS,20,20,550,80,108,.741,0,0,None,80,108,.741,.741,22,33,.667,71,92,163,23,15,35,24,34,182
467,Ziaire Williams*/players/w/willizi02.html,SF,20,MEM,19,0,339,35,99,.354,16,65,.246,19,34,.559,.434,4,6,.667,5,23,28,12,8,6,11,33,90
468,Dylan Windler*/players/w/windldy01.html,SF,25,CLE,18,0,189,17,38,.447,10,25,.400,7,13,.538,.579,3,4,.750,8,24,32,18,5,2,8,19,47
469,Justise Winslow*/players/w/winslju01.html,SF,25,LAC,17,0,129,15,40,.375,1,8,.125,14,32,.438,.388,2,4,.500,8,27,35,17,7,5,14,11,33
470,Cassius Winston*/players/w/winstca01.html,PG,23,WAS,1,0,4,0,1,.000,0,1,.000,0,0,None,.000,2,2,1.000,0,0,0,0,0,0,1,0,2
471,Christian Wood*/players/w/woodch01.html,C,26,HOU,25,25,795,157,342,.459,43,119,.361,114,223,.511,.522,55,96,.573,48,236,284,56,13,28,47,61,412
472,Robert Woodard*/players/w/woodaro01.html,SF,22,SAC,1,0,3,0,0,None,0,0,None,0,0,None,None,0,0,None,0,0,0,0,0,0,0,0,0
473,Delon Wright*/players/w/wrighde01.html,SG,29,ATL,24,0,335,24,65,.369,8,22,.364,16,43,.372,.431,13,17,.765,18,50,68,50,16,3,11,12,69
474,McKinley Wright IV*/players/w/wrighmc01.html,PG,23,MIN,1,0,4,1,1,1.000,1,1,1.000,0,0,None,1.500,0,0,None,0,0,0,0,0,0,1,0,3
475,Thaddeus Young*/players/y/youngth01.html,PF,33,SAS,20,0,288,60,103,.583,0,3,.000,60,100,.600,.583,7,16,.438,28,40,68,50,19,6,22,27,127
476,Trae Young*/players/y/youngtr01.html,PG,23,ATL,26,26,891,238,527,.452,71,184,.386,167,343,.487,.519,141,159,.887,23,83,106,246,25,3,106,44,688
477,Omer Yurtseven*/players/y/yurtsom01.html,C,23,MIA,17,0,105,19,36,.528,0,2,.000,19,34,.559,.528,7,10,.700,6,19,25,5,1,7,7,12,45
478,Cody Zeller*/players/z/zelleco01.html,C,29,POR,24,0,319,43,76,.566,0,4,.000,43,72,.597,.566,36,47,.766,43,67,110,20,7,6,17,50,122
479,Ivica Zubac*/players/z/zubaciv01.html,C,24,LAC,26,26,648,95,142,.669,0,0,None,95,142,.669,.669,71,92,.772,64,149,213,29,13,28,32,56,261